#####O############
#                #
# ##### #        #
# #   # ## ## ## #
# # # # #  #  ## #
# # # #       #  #
# # # ####       #
#                #
####### #### # # #
#       ## # # ###
# ## ## ## # # ###
# #   # ## # # ###
# # # # ## # # ###
# # # # ## # # ###
# # # #### # # ###
#                #
#######X##########